{
  "tiles": [
    "0000000000000000000000000000000000000000",
    "0000000000000000000000000000000000000000",
    "0000000000000000000000000000000000000000",
    "0000000000000000011100000000000000000000",
    "0000000000200000000000000000000020000000",
    "0011111000000000111110000000001111100000",
    "0000000000000000000000000000000000000000",
    "0000000000000000000000000000000000030000",
    "1111111111111111111111111111111111111111"
  ]
}
